XXXXXXXXXXXXXX
XOOOOOXXOCOOOX
XOXXXOXXOXXXOX
XOXOOOCOOOOXOX
XOXOXXXXXXOXOX
XOOOOOOOOOOOOX
XOXOXX XXOXOXX
XOXOXGGGXOXOOX
XOXOXGGGXOXXOX 
XOOOXXXXXOXXOX
XOXOOOCOOOXOOX
XOXXXXOXXXXOXX
XOOOOOOOOOO PX
XXXXXXXXXXXXXX