XXXXXXXXXXXXXXXXXXXXXXX
XOOOOOOOX  XOOOOOCOOOOX
XOXXXXXOXXXXOXXXXXXXXOX
XOXOOOXOOOOOOXOOOOOOXOX
XOOOXOXOXX XXOOXXOXOOOX
XOXOXOOOXGGGXOXXXXXXXOX
XOXCXOXOXGGGXOOXOOOOXOX
XOXXXOXXXXXXXXOXOXXOXOX
XOOOOOOOOOOOOOOOOOOOPOX
XXXXXXXXXXXXXXXXXXXXXXX     