XXXXXXXXXXX  XXXXXXXXXXXXXXXXX
XOOOOOOOOOX  XOOOOOOOXOOOOXOCX
XOXXXOXXXOXXXXOXXXOXOOOXXOOOXX
XOX XOX XOOOOOOXOOOXOXOOOOXOOX
XOXXXOXXXOXXXOXXXOXXOXXXXOXXOX
XOOOOOOOOOXGGGGGXOXOOXOOOOXOOX
XXXXXOXXXOXGGGGGXOXOXXOXXOOOXX
XOOOOOXOOOXGGGGGXOXOXOOXXXOXCX
XOXXXOXOXXXXXXXXXOOOXOX  XOXOX
XOX XOXOOOOOOXXCXXXOXOXXXXOOOX
XOXXXOXXXXXXOXXOX XOOOX  XOXOX
XOOOOOX    XOOOOXXXOXOXXXXOXOX
XOXXXOXXXXXXOXXOOOOOXOOOOOOOOX
XOX XOOOOOOOOXXOXXXOXOXXXXOXOX
XOXXXOXXXOXXOXXOOOOOOOOOOPOOOX
XOOOOOOXOOOOOXXOXXXXXXOXXXOXXX
XXXXXXXXXXXXXXXXXXXXXXXXXXXXXX