XXXXXXXXXXXXXXXXXXXXXXXXXXXXXX
XOOOXOXOOOXOOOOXOOOOOOXXXXXXOX
XOXOXOOOXOOOXOXXOXXXXOOOOOOOOX
XOXCXOXOOOXOXOXXOOOOXOXOXOXOXX
XOXXXOXXXXXXXOOOOXXOXOOOOOOOOX
XOOOOOOXOOXXOOXXOXXOXOXOXOXOXX
XOXOXOOOOOOOOOOOOOXOXOOOOOOOOX
XXXOXXXXXXXOOXXOXXXOXXXXXXXXXX
XOOOOOOOOOXOOOOOXOOOOXOOOOXOCX
XOXXXOXXXOXXOXOXXXOXOOOXXOOOXX
XOXOOOXOOOOOOOOOOOOXOXOOOOXOOX
XOXXXOXXXOXXXOXXXOXXOXXXXOXXOX
XOOOOOOOOOXGGGGGXOXOOXOOOOXOOX
XXXXXOXXXOXGGGGGXOXOXXOXXOOOXX
XOOOOOXOOOXGGGGGXOXOXOOXXXOXCX
XOXXXOXOXXXXXXXXXOOOXOOOGXOXOX
XOXCXOOOOOOOOXXCXXXOXOXXXXOOOX
XOXOXOXXXXXXOXXOXMXOOOXMMXOXOX
XOOOOOXOOOOXOOOOXXXOXOXXXXOXOX
XOXOXOXOXXXXOXXOOOOOXOOOOOOOOX
XOXGXOOOOOXOOXXOXXXOXOXXXXOXOX
XOXXXOXXXOXXXXXOOOOOOOOOOPOOOX
XOOOOOOXOOOOOXXOXXXXXXOXXXOXXX
XXXXXXXXXXXXXXXXXXXXXXXXXXXXXX